{
  "BLOCK_MAP": [
    "   111111   ",
    " 1111111111 ",
    " 1111111111 ",
    " 1111111111 ",
    "   111111   ",
    "            ",
    "            ",
    "            ",
    "            "
  ]
}