{
  "BLOCK_MAP": [
    "1 1 1 1 1 1 ",
    " 1 1 1 1 1 1",
    "1 1 1 1 1 1 ",
    " 1 1 1 1 1 1",
    "1 1 1 1 1 1 ",
    "            ",
    "            ",
    "            ",
    "            "
  ]
}